+-------------------------------------------+
|XXXXXXXXXXXXXXXXXXXXXXXXXXXXXXXXXXXXXXXXXXX|
| S                                         |
|XXXXXXXXXXXXXXXXXXXXXXXXXXXXXXXXXXXXXXXXXX |
|                                           |
| XXXXXXXXXXXXXXXXXXXXXXXXXXXXXXXXXXXXXXXXXX|
|                                           |
|XXXXXXXXXXXXXXXXXXXXXXXXXXXXXXXXXXXXXXXXXX |
|                                           |
| XXXXXXXXXXXXXXXXXXXXXXXXXXXXXXXXXXXXXXXXXX|
|                                           |
|XXXXXXXXXXXXXXXXXXXXXXXXXXXXXXXXXXXXXXXXXX |
|                                           |
| XXXXXXXXXXXXXXXXXXXXXXXXXXXXXXXXXXXXXXXXXX|
|                                           |
|XXXXXXXXXXXXXXXXXXXXXXXXXXXXXXXXXXXXXXXXXX |
|                                           |
| XXXXXXXXXXXXXXXXXXXXXXXXXXXXXXXXXXXXXXXXXX|
|                                          G|
+-------------------------------------------+