+--------------------------------------------------------------------------------------+
|X    XX X   X     X    XXXXXXXXXXXXXXXXXXXXXXXXX X XXXX X XXX XXX X XXXXXXXXXXXXXXXXXX|
| S X X    X X X X   X       XX      XXX            X  X     X X     XXXXXXX           |
|XXXX X XXXX X XXX XXX X XXXXXXXXXXXXXXXXXX    X X    X X X X   X X           X        |
|       X  X     X X     XXXXXXXX     X      XXXXXXXXXXX XXXXXXX X XXXXXX XX XXXX X X X|
| XXXXXXXXXXXXX X  XXXXX XXXXXXXXXXXXXXXXXXX XXX X XXX XX XXXXXXXXXXXXXXXXXXXXXXX X XXX|
| X   X   X  X    X     X            X   X   XXXXXXXXXXX XXX XXX X XXXXXX XX XXXX X X X|
| XXX X XXX XX X XXXXXXXXXXXXXXXXXXXXX X XXX X   X   X  X    X     X            X   X  |
|  XX    X     X             X X     X X X  XX    X     X                     X X X X  |
|X X  X XXX XXXX XXXXXXXXX X X X X X X X X XX    XX X   X     X    XXXXXXXXXXXX  XXXXXX|
|    X  X X XXXX   XX      X   X   X          XX    X     X                     X X X X|
|X X X XX XXXXXXXX XX XX XXXXXXXX XXXX XXXXX X   X       X              X    X  X   X X|
|  X               XX X  XX  X  X      X    X X  X XXX XXXXXX  XXXXXXXXXXXXXX X X X X X|
| XXXXXXXXXXX XXXXXXX X XXXXXX XX XXXX X X XX    XX X   X     X    XXXXXXXXXXXX  XXXXXX|
| X   X       X              X    X  X   X X X   X       X              X    X  X   X X|
| X X XXX XXX XXX XXXXXXXXXX X X XX   XXXX   X   X   X  X    X     X            X   X  |
|   X X   X       X    X   X   X    X X     X X X XX XXXXXXXXXXX XX XX XXXXX XXXX XXXXX|
|X X  XX XXXXXXX XXXXX XX X X XXXXXX X X X X  X           XXXXXX X  XX  X  X      X    |
|  X         X     XX X  X     X    X   X  XX X  XX XXXXXXX XXXXX XX X X XXXXXX X X X X|
|X   X  XXXX    XXX   X    XXX   XX      XXX  X                  X  XX  X  X      X    |
|X    XX X   X     X    XXXXXXXXXXXX  XXXXXX X   X   X  X    X     X            X   X  |
|   X X    X X X X   X X           X        X X  XX XXXXXXX XXXXX XX X X XXXXXX X X X X|
|X XX X XXXX X XXX XXX X XX XXX XX XXXXXXXX    X X   X       X    X   X   X    X X     |
|       X  X     X X            X           X X  XX XXXXXXX XXXXX XX X X XXXXXX X X X X|
| XXX XXXXXXXXX X  XXXXX XX XXX XXXXXXXXXXXX   X X    X X X X   X X           X      XX|
| X   X   X  X    X     X            X   X    X       XX  XXXXXX X  XX  X  X      X    |
| XXX X XXX XX XXXXXXXXXXXXXXXXXXXXXXX X XXX X   X XXX   X              X    X  X   X X|
|  XX    X     X                     X X X X  X         X     XX X  X     X    X   X  X|
|X X  X XXX XXXXXX  XXXXXXXXXXXXXX X X X X XX X X XX XX X X  XXX XX  XXXXXXX XXXX XXX X|
|    X  X X X       X              X        X X  XX XXX   X X   X XX X X XXXXXX XXX   X|
|X X X XX XXXXXXX XXX XX XXXXXXXX XXXX XXXXXX X  XX XXXX XX X X   XX X X     XX X   X X|
|  X                  X  XX  X  X      X    X X X XX XXX XX   XX      XXX XX XXXX XXXXX|
| XXXXXXXXXXX XXX XXX X XXXXXX XX XXXX X X X XXXXXXXXXX  XXX XXX X XX XXX XX XXXX X X X|
| X   X       X              X    X  X   X X  X         X     XX X  X     X    X   X  X|
| X X XXX XXX XXX XXXXXXXXXX X X XX   XXXX   X X XXX XXX XXX XXX XXXXXX X X XX   XXXX  |
|   X X   X       X    X   X   X    X X        X X   X            X   X        X       |
|X X  XX XXXXXXX XXXXX XX X X XXXX X X X X X XXXXXXX   X XXX XXX X XX   X XX X XX X X  |
|  X         X     XX X  X     X    X   X  X X X XXX XXX XXX XXXXXXXXXX X X  X    XXXG |
+--------------------------------------------------------------------------------------+